
NO textures/sprite_0.xpm



SO textures/sprite_1.xpm
WE textures/sprite_2.xpm
EA textures/sprite_3.xpm




F 0,255,0
C 0,238,255






        1111111111111111111111111
        100D000000110000000000001
        101100000111000000000000111111111
        10010000000D000000000000000000001
11111111101100000111000000000000111110001   
100000000011000001110111111111111   10001
11110111111111011100000010001       11111
1111D111111111001101010010001
10000000110101011100000010001
1000000D00000001100000010001
1000N000000000001101010000001
11000001110101011111011110000111
11110111 1110101 101111010001
11111111 1111111 111111111111
