NO textures/sprite_0.xpm
SO textures/sprite_1.xpm
WE textures/sprite_2.xpm
EA textures/sprite_3.xpm




F 0,255,0
C 0,238,255






        1111111111111111111111111111
        1000000000110000000000000001
        1011000001110000000000000001
        1001000000000000000000000001
111111110011000001110000000000000001
100000000011000001110111111111111001
11110111111111011100000010001  11001111111
1111D111111111011101010010001  10000000001
11000000110101011100010010001  11111111111
10000000000000000000000000001
1000N000000000001101010010001
1100000111010101111101111000011
11110111 1110101 101111010001
11111111 1111111 111111111111
