NO textures/north.xpm
SO textures/south.xpm
WE textures/west.xpm
EA textures/east.xpm




F 221,161,239
C 178,244,252






         111111111111111111111111
        100D000000110000000000001
        101100000111000000000000111111111
        10010000000D000000000000000000001
11111111101100000111000000000000111110001   
100000000011000001110111111111111   10001
11110111111111011100000010001       11111
11110111111111001101010010001
11000000110101011100000010001
1000000000000001100000010001
10000000000000001101010000001
11000001110101011111011110E00111
11110111 1110101 101111010001
11111111 1111111 111111111111
