NO ../textures/north.xpm
SO ../textures/south.xpm
WE ../textures/west.xpm
EA ../textures/east.xpm

F 221,161,239
C 178,244,252

1111111111111111111111111
1N0D000000110000000000001
1011000001110000000000001
1001000000000000000000001
111111111111111111111111