NO ../textures/north.xpm
SO ../textures/south.xpm
WE ../textures/west.xpm
EA ../textures/east.xpm

F 221,161,239

1111111111111111111111111
1000000000110000000000001
1011000001110000000000001
100100000000000N000000001
1111111111111111111111111