NO ./textures/debug64x128.xpm
SO ./textures/south.xpm
WE ./textures/west.xpm
EA ./textures/east.xpm

F 221,161,239
C 178,244,252

1111111
1010001
100N001
1000001
1000001
1110111
1000001
1000001
1000001
1000001
1111111
