NO textures/north.xpm
SO textures/south.xpm
WE textures/west.xpm
EA textures/east.xpm




F 255,255,255
C 0,0,0

111111111111111111111111111111111111111111111
111000000000000010000000000010000000000000111
1100000000000000000000N0000000000000000000001
111111110000000000000011110000000000000000001
100000011101111111111011111111101111111101111
110111011101111111111011111111101111111101111
110111000001111111111011111111101111111101111
110111111111111111111011111111101111111101111
110000000111111111111011111111101111111101111
111111111111111111111011111111101111111101111
111111111111111111111011111111101111111111111
111111111111111111111011111111111111111111111
111111111111111111111011111111111111111111111
111000000000000010000000000010000000000000111
1100000000000000000000N0000000000000000000001
111111110000000000000011110000000000000000001
100000011101111111111011111111101111111101111
110111011101111111111011111111101111111101111
110111000001111111111011111111101111111101111
110111111111111111111011111111101111111101111
110000000111111111111011111111101111111101111
111111111111111111111011111111101111111101111
111111111111111111111111111111111111111111111
111111111111111111111111111111111111111111111