NO textures/north.xpm
SO textures/south.xpm
WE textures/west.xpm
EA textures/east.xpm

F 221,161,239
C 178,244,252

1111
1E01
1111