NO textures/sprite_0.xpm
SO textures/sprite_1.xpm
WE textures/sprite_2.xpm
EA textures/sprite_3.xpm




F 0,255,0
C 0,238,255

1111
1E01
1111